1 0,15 0,1 0,0 0,0 0,0 0,0 0,0 0,0 0,0 0,0 0,0 0,0 0,0 0,0 0,0 0,0 0,0 0,1 0,0 0,0 0,0 0,1 0,15 0,1 0,0 0,0 0,0 0,0 0,0 0,1 0,1 0
0 0,5 0,0 0,1 0,1 0,1 0,1 0,1 0,1 0,1 0,1 0,1 0,1 0,1 0,1 0,1 0,1 0,1 0,0 0,1 0,1 0,1 0,15 0,1 0,0 0,1 0,1 0,1 0,1 0,1 0,15 0,1 0
0 0,1 0,0 0,1 0,0 0,1 0,1 0,0 0,0 0,0 0,0 0,0 0,0 0,0 0,0 0,1 0,15 0,1 0,0 0,1 0,15 0,1 0,1 0,1 0,0 0,1 0,15 0,1 0,15 0,1 0,1 0,0 0
0 0,1 0,0 0,1 0,0 0,1 0,0 0,1 0,1 0,1 0,1 0,1 0,1 0,1 0,1 0,15 0,1 0,1 0,1 0,15 0,1 0,15 0,1 0,1 0,0 0,1 0,1 0,15 0,1 0,0 0,1 0,0 0
0 0,1 0,1 0,15 0,1 0,1 0,0 0,1 0,1 0,0 0,0 0,1 0,1 0,15 0,1 0,1 0,1 0,1 0,1 0,1 0,1 0,1 0,15 0,1 0,0 0,1 0,1 0,1 0,1 0,0 0,1 0,0 0
0 0,1 0,1 0,1 0,1 0,1 0,0 0,1 0,0 0,1 0,1 0,15 0,1 0,1 0,0 0,1 0,0 0,0 0,0 0,1 0,1 0,15 0,1 0,1 0,1 0,0 0,0 0,0 0,0 0,1 0,1 0,0 0
0 0,1 0,15 0,1 0,0 0,0 0,1 0,1 0,0 0,1 0,15 0,1 0,1 0,0 0,0 0,1 0,1 0,1 0,1 0,15 0,1 0,1 0,15 0,1 0,1 0,1 0,1 0,1 0,1 0,1 0,1 0,0 0
0 0,1 0,1 0,15 0,1 0,0 0,1 0,1 0,0 0,1 0,1 0,15 0,1 0,1 0,1 0,0 0,0 0,0 0,0 0,1 0,1 0,0 0,1 0,1 0,0 0,1 0,1 0,15 0,1 0,15 0,1 0,0 0
1 0,0 0,1 0,1 0,1 0,1 0,15 0,1 0,0 0,1 0,15 0,1 0,15 0,1 0,1 0,1 0,1 0,1 0,1 0,1 0,1 0,0 0,1 0,1 0,0 0,1 0,0 0,1 0,15 0,1 0,15 0,1 0
1 0,0 0,0 0,0 0,1 0,0 0,1 0,1 0,0 0,1 0,1 0,15 0,1 0,15 0,1 0,0 0,0 0,0 0,0 0,0 0,0 0,0 0,0 0,0 0,1 0,1 0,0 0,1 0,1 0,1 0,1 0,0 0
0 0,1 0,1 0,1 0,1 0,0 0,1 0,1 0,0 0,1 0,1 0,1 0,1 0,1 0,1 0,1 0,1 0,1 0,1 0,1 0,1 0,1 0,1 0,1 0,1 0,1 0,0 0,1 0,15 0,1 0,1 0,0 0
0 0,1 0,0 0,1 0,15 0,1 0,1 0,0 0,1 0,0 0,1 0,0 0,1 0,0 0,0 0,0 0,0 0,0 0,0 0,0 0,0 0,0 0,0 0,0 0,0 0,1 0,0 0,1 0,1 0,15 0,1 0,0 0
0 0,1 0,0 0,1 0,1 0,15 0,1 0,0 0,1 0,1 0,0 0,1 0,0 0,1 0,1 0,1 0,1 0,1 0,1 0,1 0,1 0,1 0,1 0,1 0,1 0,15 0,1 0,1 0,15 0,1 0,1 0,0 0
0 0,1 0,0 0,1 0,15 0,1 0,1 0,1 0,1 0,1 0,1 0,1 0,1 0,1 0,1 0,15 0,1 0,15 0,1 0,15 0,1 0,15 0,1 0,1 0,1 0,1 0,15 0,1 0,1 0,15 0,1 0,0 0
0 0,1 0,0 0,1 0,1 0,0 0,0 0,0 0,0 0,0 0,0 0,0 0,1 0,0 0,0 0,1 0,15 0,1 0,15 0,1 0,15 0,1 0,15 0,1 0,1 0,15 0,1 0,1 0,15 0,1 0,1 0,0 0
0 0,1 0,0 0,1 0,1 0,1 0,1 0,1 0,1 0,1 0,1 0,1 0,15 0,1 0,1 0,1 0,1 0,1 0,1 0,1 0,1 0,1 0,1 0,0 0,1 0,1 0,15 0,1 0,1 0,0 0,1 0,0 0
0 0,1 0,0 0,1 0,1 0,15 0,1 0,15 0,1 0,15 0,1 0,15 0,1 0,1 0,1 0,15 0,1 0,15 0,1 0,15 0,1 0,15 0,1 0,0 0,1 0,15 0,1 0,15 0,1 0,0 0,1 0,0 0
0 0,1 0,1 0,0 0,0 0,1 0,15 0,1 0,15 0,1 0,15 0,1 0,15 0,1 0,0 0,1 0,15 0,1 0,15 0,1 0,15 0,1 0,1 0,0 0,1 0,1 0,15 0,1 0,1 0,0 0,1 0,0 0
0 0,1 0,1 0,1 0,1 0,1 0,1 0,1 0,1 0,1 0,1 0,1 0,1 0,1 0,0 0,1 0,1 0,1 0,1 0,1 0,3 0,15 0,1 0,0 0,1 0,15 0,1 0,1 0,1 0,0 0,1 0,0 0
0 0,1 0,0 0,0 0,0 0,0 0,1 0,0 0,0 0,0 0,0 0,0 0,0 0,0 0,1 0,1 0,1 0,0 0,0 0,0 0,0 0,1 0,1 0,0 0,1 0,1 0,15 0,1 0,15 0,1 0,1 0,0 0
0 0,1 0,1 0,1 0,1 0,1 0,15 0,1 0,1 0,1 0,1 0,1 0,1 0,1 0,1 0,1 0,0 0,1 0,1 0,1 0,1 0,1 0,1 0,0 0,1 0,15 0,1 0,1 0,1 0,0 0,1 0,0 0
1 0,0 0,0 0,0 0,1 0,1 0,1 0,0 0,0 0,0 0,0 0,0 0,0 0,0 0,1 0,1 0,0 0,1 0,0 0,0 0,0 0,1 0,1 0,0 0,1 0,1 0,0 0,0 0,1 0,0 0,1 0,0 0
0 0,1 0,1 0,1 0,0 0,1 0,1 0,1 0,1 0,1 0,1 0,1 0,1 0,1 0,15 0,1 0,0 0,1 0,1 0,1 0,1 0,0 0,1 0,0 0,1 0,1 0,1 0,1 0,1 0,0 0,1 0,0 0
0 0,1 0,0 0,1 0,0 0,1 0,0 0,0 0,1 0,0 0,0 0,1 0,1 0,15 0,1 0,1 0,0 0,1 0,15 0,1 0,0 0,0 0,1 0,0 0,1 0,15 0,1 0,15 0,1 0,0 0,1 0,0 0
0 0,1 0,0 0,1 0,0 0,1 0,1 0,1 0,0 0,1 0,1 0,15 0,1 0,1 0,15 0,1 0,1 0,15 0,1 0,15 0,1 0,1 0,15 0,1 0,15 0,1 0,15 0,1 0,15 0,1 0,1 0,0 0
0 0,1 0,0 0,1 0,0 0,1 0,15 0,1 0,0 0,1 0,15 0,1 0,1 0,0 0,1 0,1 0,1 0,1 0,1 0,1 0,1 0,1 0,1 0,1 0,1 0,1 0,1 0,1 0,1 0,15 0,1 0,0 0
0 0,1 0,1 0,15 0,1 0,15 0,1 0,1 0,0 0,1 0,1 0,1 0,1 0,0 0,0 0,0 0,0 0,0 0,0 0,0 0,0 0,0 0,0 0,0 0,0 0,1 0,0 0,0 0,0 0,1 0,1 0,0 0
0 0,1 16,1 0,1 0,1 0,1 0,1 0,1 0,1 0,0 0,0 0,0 0,0 0,1 0,1 0,1 0,1 0,1 0,1 0,1 0,1 0,1 0,1 0,1 0,1 0,1 0,1 0,1 0,1 0,1 0,1 0,0 0
0 0,1 0,15 0,1 0,15 0,1 0,15 0,1 0,15 0,1 0,1 0,1 0,1 0,1 0,1 0,0 0,0 0,0 0,0 0,0 0,0 0,0 0,0 0,0 0,0 0,0 0,0 0,0 0,0 0,0 0,1 0,0 0
1 0,15 0,1 0,15 0,1 0,15 0,1 0,15 0,1 0,1 0,1 0,0 0,0 0,0 0,0 0,1 0,1 0,1 0,1 0,1 0,1 0,1 0,1 0,1 0,1 0,1 0,1 0,1 0,1 0,1 0,1 0,0 0
15 0,1 0,1 0,1 0,1 0,1 0,1 0,1 0,1 0,1 0,15 0,1 0,1 0,1 0,1 0,1 0,15 0,1 0,15 0,1 0,15 0,1 0,15 0,1 0,15 0,1 0,15 0,1 0,15 0,1 0,15 0,1 0
1 0,0 0,0 0,0 0,0 0,0 0,0 0,0 0,0 0,0 0,1 0,0 0,0 0,0 0,0 0,0 0,1 0,15 0,1 0,15 0,1 0,15 0,1 0,15 0,1 0,15 0,1 0,15 0,1 0,15 0,1 0,1 0
