0 0,0 0,1 0,1 0,27 0,1 0,1 0,0 0,0 0,0 0,0 0,0 0,0 0,0 0,0 0,0 0
0 0,0 0,1 0,1 0,1 0,1 0,1 0,0 0,0 0,0 0,0 0,0 0,0 0,0 0,0 0,0 0
0 0,0 0,1 0,1 16 3,0 0,1 0,1 0,0 0,0 0,0 0,0 0,0 0,0 0,0 0,0 0,0 0
0 0,0 0,1 0,1 0,0 0,1 0,1 0,1 0,4 0,4 0,1 0,1 0,1 0,1 0,1 0,27 0
3 0,49 0,1 0,1 16 3,0 0,0 0,1 0,1 0,4 0,4 0,1 0,1 26,1 26,5 1,33 0,1 0
0 0,0 0,1 0,1 0,0 0,1 0,1 0,1 0,4 0,4 0,1 0,1 0,1 0,1 0,1 0,27 0
0 0,0 0,1 0,1 16 3,0 0,1 0,1 0,0 0,0 0,0 0,0 0,0 0,0 0,0 0,0 0,0 0
0 0,0 0,1 0,1 0,1 0,1 0,1 0,0 0,0 0,0 0,0 0,0 0,0 0,0 0,0 0,0 0
0 0,0 0,1 0,1 0,27 0,1 0,1 0,0 0,0 0,0 0,0 0,0 0,0 0,0 0,0 0,0 0
