0 0,0 0,11 0,10 36 1,10 0,10 36 1,12 0,0 0,0 0,0 0,0 0,0 0,0 0,0 0,0 0,0 0
0 0,0 0,10 36 3,27 0,27 0,27 0,10 36 0,0 0,0 0,0 0,0 0,0 0,1 0,1 0,1 0,0 0
0 0,0 0,10 0,1 0,1 0,1 0,10 0,0 0,0 0,0 0,0 0,0 0,1 0,1 0,1 0,0 0
0 0,0 0,10 36 3,1 0,5 0,1 0,10 0,0 0,0 0,0 0,3 0,0 0,1 0,1 26,1 0,0 0
0 0,38 0,10 0,1 0,1 0,1 0,10 0,4 0,4 0,49 0,1 0,0 0,1 0,1 0,1 0,38 0
0 0,0 0,10 36 3,1 0,24 0,1 0,10 0,0 0,0 0,0 0,3 0,0 0,1 0,1 26,1 0,0 0
0 0,0 0,10 0,1 0,1 0,1 0,10 0,0 0,0 0,0 0,0 0,0 0,1 0,1 0,1 0,0 0
0 0,0 0,10 36 3,27 0,27 0,27 0,10 36 0,0 0,0 0,0 0,0 0,0 0,1 0,1 0,1 0,0 0
0 0,0 0,13 0,10 36 2,10 0,10 36 2,14 0,0 0,0 0,0 0,0 0,0 0,0 0,0 0,0 0,0 0
