0 0,0 0,40 0,0 0,0 0,0 0,40 0,0 0,0 0,0 0,40 0,0 0,0 0,0 0,40 0,0 0,0 0,0 0,40 0,0 0,0 0,0 0,40 0,0 0,0 0,0 0,40 0,0 0,0 0
0 0,40 0,40 0,40 0,0 0,40 0,40 0,40 0,0 0,40 0,40 0,40 0,0 0,40 0,40 0,40 0,0 0,40 0,40 0,40 0,0 0,40 0,40 0,40 0,0 0,40 0,40 0,40 0,0 0
40 0,40 0,3 0,40 0,40 0,40 0,40 0,40 0,0 0,40 0,40 0,40 0,40 0,40 0,40 0,40 0,40 0,40 0,40 0,40 0,40 0,40 0,40 0,40 0,40 0,40 0,40 0,40 0,40 0
0 0,40 0,40 0,40 0,0 0,40 0,40 0,40 0,0 0,40 0,40 0,40 0,0 0,40 0,40 0,40 0,0 0,40 0,40 0,40 0,0 0,40 0,40 0,40 0,0 0,40 0,40 0,40 0,0 0
0 0,0 0,40 0,0 0,0 0,0 0,0 0,0 0,0 0,0 0,40 0,0 0,0 0,0 0,40 0,0 0,0 0,0 0,0 0,0 0,0 0,0 0,0 0,0 0,0 0,0 0,40 0,0 0,0 0
0 0,40 0,40 0,40 0,0 0,40 0,40 0,40 0,0 0,40 0,40 0,40 0,0 0,40 0,40 0,40 0,0 0,40 0,40 0,40 0,0 0,40 0,40 0,40 0,0 0,40 0,40 0,40 0,0 0
40 0,40 0,40 0,40 0,0 0,40 0,40 0,40 0,40 0,40 0,40 0,40 0,40 0,40 0,40 0,40 0,40 0,40 0,40 0,40 0,40 0,40 0,40 0,40 0,0 0,40 0,40 0,40 0,40 0
0 0,40 0,40 0,40 0,0 0,40 0,40 0,40 0,0 0,40 0,40 0,40 0,0 0,40 0,40 0,40 0,0 0,40 0,40 0,40 0,0 0,40 0,40 0,40 0,0 0,40 0,40 0,40 0,0 0
0 0,0 0,40 0,0 0,0 0,0 0,40 0,0 0,0 0,0 0,0 0,0 0,0 0,0 0,0 0,0 0,0 0,0 0,40 0,0 0,0 0,0 0,40 0,0 0,0 0,0 0,0 0,0 0,0 0
0 0,40 0,40 0,40 0,0 0,40 0,40 0,40 0,0 0,40 0,40 0,40 0,0 0,40 0,40 0,40 0,0 0,40 0,40 0,40 0,0 0,40 0,40 0,40 0,0 0,40 0,40 0,40 0,0 0
40 0,40 0,40 0,40 0,0 0,40 0,40 0,40 0,0 0,40 0,40 0,40 0,0 0,40 0,33 0,40 0,0 0,40 0,40 0,40 0,40 0,40 0,40 0,40 0,40 0,40 0,40 0,40 0,40 0
0 0,40 0,40 0,40 0,0 0,40 0,40 0,40 0,0 0,40 0,40 0,40 0,0 0,40 0,40 0,40 0,0 0,40 0,40 0,40 0,0 0,40 0,40 0,40 0,0 0,40 0,40 0,40 0,0 0
0 0,0 0,40 0,0 0,0 0,0 0,40 0,0 0,0 0,0 0,40 0,0 0,0 0,0 0,40 0,0 0,0 0,0 0,40 0,0 0,0 0,0 0,0 0,0 0,0 0,0 0,0 0,0 0,0 0
0 0,40 0,40 0,40 0,0 0,40 0,40 0,40 0,0 0,40 0,40 0,40 0,0 0,5 0,40 0,24 0,0 0,40 0,40 0,40 0,0 0,40 0,40 0,40 0,0 0,40 0,40 0,40 0,0 0
40 0,40 0,40 0,40 0,0 0,40 0,40 0,40 0,0 0,40 0,40 0,40 0,40 0,40 0,40 0,40 0,40 0,40 0,40 0,40 0,40 0,40 0,40 0,40 0,40 0,40 0,40 0,40 0,40 0
0 0,40 0,40 0,40 0,0 0,40 0,40 0,40 0,0 0,40 0,40 0,40 0,0 0,40 0,40 0,40 0,0 0,40 0,40 0,40 0,0 0,40 0,40 0,40 0,0 0,40 0,40 0,40 0,0 0
0 0,0 0,40 0,0 0,0 0,0 0,40 0,0 0,0 0,0 0,0 0,0 0,0 0,0 0,40 0,0 0,0 0,0 0,40 0,0 0,0 0,0 0,0 0,0 0,0 0,0 0,40 0,0 0,0 0
0 0,40 0,40 0,40 0,0 0,40 0,40 0,40 0,0 0,40 0,40 0,40 0,0 0,40 0,40 0,40 0,0 0,40 0,40 0,40 0,0 0,40 0,40 0,40 0,0 0,40 0,40 0,40 0,0 0
40 0,40 0,40 0,40 0,0 0,40 0,40 0,40 0,40 0,40 0,40 0,40 0,40 0,40 0,40 0,40 0,0 0,40 0,40 0,40 0,40 0,40 0,40 0,40 0,0 0,40 0,40 0,40 0,40 0
0 0,40 0,40 0,40 0,0 0,40 0,40 0,40 0,0 0,40 0,40 0,40 0,0 0,40 0,40 0,40 0,0 0,40 0,40 0,40 0,0 0,40 0,40 0,40 0,0 0,40 0,40 0,40 0,0 0
0 0,0 0,40 0,0 0,0 0,0 0,0 0,0 0,0 0,0 0,0 0,0 0,0 0,0 0,0 0,0 0,0 0,0 0,0 0,0 0,0 0,0 0,40 0,0 0,0 0,0 0,40 0,0 0,0 0
0 0,40 0,40 0,40 0,0 0,40 0,40 0,40 0,0 0,40 0,40 0,40 0,0 0,40 0,40 0,40 0,0 0,40 0,40 0,40 0,0 0,40 0,40 0,40 0,0 0,40 0,40 0,40 0,0 0
40 0,40 0,40 0,40 0,0 0,40 0,40 0,40 0,40 0,40 0,40 0,40 0,40 0,40 0,40 0,40 0,40 0,40 0,40 0,40 0,40 0,40 0,40 0,40 0,0 0,40 0,40 0,40 0,40 0
0 0,40 0,40 0,40 0,0 0,40 0,40 0,40 0,0 0,40 0,40 0,40 0,0 0,40 0,40 0,40 0,0 0,40 0,40 0,40 0,0 0,40 0,40 0,40 0,0 0,40 0,40 0,40 0,0 0
0 0,0 0,40 0,0 0,0 0,0 0,0 0,0 0,0 0,0 0,40 0,0 0,0 0,0 0,0 0,0 0,0 0,0 0,0 0,0 0,0 0,0 0,0 0,0 0,0 0,0 0,40 0,0 0,0 0
0 0,40 0,40 0,40 0,0 0,40 0,40 0,40 0,0 0,40 0,40 0,40 0,0 0,40 0,40 0,40 0,0 0,40 0,40 0,40 0,0 0,40 0,40 0,40 0,0 0,40 0,40 0,40 0,0 0
40 0,40 0,40 0,40 0,40 0,40 0,40 0,40 0,40 0,40 0,40 0,40 0,0 0,40 0,40 0,40 0,40 0,40 0,40 0,40 0,40 0,40 0,40 0,40 0,40 0,40 0,3 0,40 0,40 0
0 0,40 0,40 0,40 0,0 0,40 0,40 0,40 0,0 0,40 0,40 0,40 0,0 0,40 0,40 0,40 0,0 0,40 0,40 0,40 0,0 0,40 0,40 0,40 0,0 0,40 0,40 0,40 0,0 0
0 0,0 0,40 0,0 0,0 0,0 0,40 0,0 0,0 0,0 0,40 0,0 0,0 0,0 0,40 0,0 0,0 0,0 0,40 0,0 0,0 0,0 0,40 0,0 0,0 0,0 0,40 0,0 0,0 0
